1111111111111111111111111111111111111111111
0000000000000000000000000000000000000000001
1111111110111111111101111111111110111111111
1000000000111000010001000000010000000000001
1011111110000010110111011111010111111111101
1110000000111110110000010000010000000000001
1000111111111110111111110111111111111011111
1011111000000000000000110110000000001000001
1010001011011111111110110000111111111111101
1010101011000000000010111111110000000000001
1111101011111111111010000000010111111111111
1000001000000000001011111111010000000000001
1011111111111111101000001000011111111111101
1111111111111111111111111111111111111111101